Α α	alfa
Β β	beta
Γ γ	gamma
Δ δ	delta
Ε ε	epsilon
Ζ ζ	dzeta
Η η	eta
Θ θ	theta
Ι ι	jota
Κ κ	kappa
Λ λ	lambda
Μ μ	my
Ν ν	ny
Ξ ξ	ksi
Ο ο	omikron
Π π	pi
Ρ ρ	rho
Σ σ ς	sigma
Τ τ	tau
Υ υ	ipsyln
Φ φ	phi
Χ χ	chi
Ψ ψ	psi
Ω ω	omega
∈ ÷ ≠ ⊥ ∨ ∧ ∪ ∩ ∞ ⌀ ≤ ≥ 〈 〉 ⊂ ⊃









